%%%%%%%%%%%%%%%%%%%%%%%%%%%%%%%%%%%%%%%%%%%%%%%%%%%%%%%%%%%%%%%%%%%%%%%%%%%%%%%%%%%%%%%%%%%%%%%%%%%%%%
%%%%%%%%%%%%%%%%%%%%%%%%%%%%%%%%%%%%%%%%%%%%%%%%%%%%%%%%%%%%%%%%%%%%%%%%%%%%%%%%%%%%%%%%%%%%%%%%%%%%%%
%% @  %%%%%%      %%%%    %%%%%%              %%%%%%      %%%%    %%%%%%      %%%%    %%%%%%      %%%%
%%    %%%%%%      %%%%    %%%%%%      %%%%    %%%%%%      %%%%    %%%%%%      %%%%    %%%%%%      %%%%
%%    %           %%%%    %           %%%%    %           %%%%    %           %%%%    %           %%%%
%%    %    %      %%%%    %    %      %%%%    %    %      %%%%    %    %       %%%    %    %      %%%%
%%         %      %%%%         %      %%%%         %        %%         %      % %%         %      %%%%
%%         %                   %                   %      %            %      %%           %      %%%%
%%%  %%%%%%%%%%%%%%%%%%%%%%%%%%%%%%%%%%%%%%%%%%%%%%%%%%%%%%%%%%%%%%%%%%%%%%%%%%%%%%%%%%%%%%%%%% %%%%%%
%%%  %%%%%%%%%%%%%%%%%%%%%%%%%%%%%%%%%%%%%%%%%%%%%%%%%%%%%%%%%%%%%%%%%%%%%%%%%%%%%%%%%%%%%%%%%% %%%%%%
%%%  %%%%%%%%%%%%%%%%%%%%%%%%%%%%%%%%%%%%%%%%%%%%%%%%%%%%%%%%%%%%%%%%%%%%%%%%%%%%%%%%%%%%%%%%% %%%%%%%
%%%  %%%%%%%%%%%%%%%%%%%%%%%%%%%%%%%%%%%%%%%%%%%%%%%%%%%%%%%%%%%%%%%%%%%%%%%%%%%%%%%%%%%%%%%% %%%%%%%%
%%    %%%%%%      %%%%    %%%%%%              %%%%%%      %%%%    %%%%%%      %%%%    %%%%%%      %%%%
%%    %%%%%%      %%%%    %%%%%%      %%%%    %%%%%%      %%%%    %%%%%%      %%%%    %%%%%%      %%%%
%%    %           %%%%    %           %%%%    %           %%%%    %           %%%%    %           %%%%
%%    %    %      %%%%    %    %      %%%%    %    %      %%%%    %    %       %%%    %    %      %%%%
%%         %      %%%%         %      %%%%         %        %%         %      % %%         %      %%%%
%%         %                   %                   %      %            %      %%           %      %%%%
%%%%  %%%%%%%%%%%%%%%%%%%%%%%%%%%%%%%%%%%%%%%%%%%%%%%%%%%%%%%%%%%%%%%%%%%%%%%%%%%%%%%%%%%%%%%%%%%%%%%%
%%%%  %%%%%%%%%%%%%%%%%%%%%%%%%%%%%%%%%%%%%%%%%%%%%%%%%%%%%%%%%%%%%%%%%%%%%%%%%%%%%%%%%%%%%%%%%%%%%%%%
%%%%  %%%%%%%%%%%%%%%%%%%%%%%%%%%%%%%%%%%%%%%%%%%%%%%%%%%%%%%%%%%%%%%%%%%%%%%%%%%%%%%%%%%%%%%%%%%%%%%%
%%%%  %%%%%%%%%%%%%%%%%%%%%%%%%%%%%%%%%%%%%%%%%%%%%%%%%%%%%%%%%%%%%%%%%%%%%%%%%%%%%%%%%%%%%%%%%%%%%%%%
%%    %%%%%%      %%%%    %%%%%%              %%%%%%      %%%%    %%%%%%      %%%%    %%%%%%      %%%%
%%    %%%%%%      %%%%    %%%%%%      %%%%    %%%%%%      %%%%    %%%%%%      %%%%    %%%%%%      %%%%
%%    %           %%%%    %           %%%%    %           %%%%    %           %%%%    %           %%%%
%%    %    %      %%%%    %    %      %%%%    %    %      %%%%    %    %       %%%    %    %      %%%%
%%         %      %%%%         %      %%%%         %        %%         %      % %%         %      %%%%
%%         %                   %                   %      %            %      %%           %      %%%%
%%%%%%%%%%%%%%%%%%%%%%%%%%%%%%%%%%%%%%%%%%  %%%%%%%%%%%%%%%%%%%%%%%%%%%%%%%%%%%%%%%%%%%%%%%%%%  %%%%%%
%%%%%%%%%%%%%%%%%%%%%%%%%%%%%%%%%%%%%%%%%%  %%%%%%%%%%%%%%%%%%%%%%%%%%%%%%%%%%%%%%%%%%%%%%%%%%  %%%%%%
%%%%%%%%%%%%%%%%%%%%%%%%%%%%%%%%%%%%%%%%%%  %%%%%%%%%%%%%%%%%%%%%%%%%%%%%%%%%%%%%%%%%%%%%%%%%   %%%%%%
%%%%%%%%%%%%%%%%%%%%%%%%%%%%%%%%%%%%%%%%%%  %%%%%%%%%%%%%%%%%%%%%%%%%%%%%%%%%%%%%%%%%%%%%%%%  %%%%%%%%
%%    %%%%%%      %%%%    %%%%%%              %%%%%%      %%%%    %%%%%%      %%%%    %%%%%%      %%%%
%%    %%%%%%      %%%%    %%%%%%      %%%%    %%%%%%      %%%%    %%%%%%      %%%%    %%%%%%      %%%%
%%    %           %%%%    %           %%%%    %           %%%%    %           %%%%    %           %%%%
%%    %    %      %%%%    %    %      %%%%    %    %      %%%%    %    %       %%%    %    %      %%%%
%%         %      %%%%         %      %%%%         %        %%         %      % %%         %    * %%%%
%%         %                   %                   %      %            %      %%           %      %%%%
%%%%%%%%%%%%%%%%%%%%%%%%%%%%%%%%%%%%%%%%%%%%%%%%%%%%%%%%%%%%%%%%%%%%%%%%%%%%%%%%%%%%%%%%%%%%%%%%%%%%%%
%%%%%%%%%%%%%%%%%%%%%%%%%%%%%%%%%%%%%%%%%%%%%%%%%%%%%%%%%%%%%%%%%%%%%%%%%%%%%%%%%%%%%%%%%%%%%%%%%%%%%%