%%%%%%%%%%%%%%%%%%%%%%%%%%%%%%%%%%%%%%%%%%%%%%%%%%%%%%%%%%%%%%%%%%%%%%%%%%%%%%%%%%%%%%%%%%%%%%%%%%%%
%%%%%%%%%%%%%%%%%%%%%%%%%%%%%%%%%%%%%%%%%%%%%%%%%%%%%%%%%%%%%%%%%%%%%%%%%%%%%%%%%%%%%%%%%%%%%%%%%%%%
%% @  %%%%%%      %%%%    %%%%%%              %%%%%%      %%%%    %%%%%%      %%%%    %%%%%%      %%
%%    %%%%%%      %%%%    %%%%%%      %%%%    %%%%%%      %%%%    %%%%%%      %%%%    %%%%%%      %%
%%    %           %%%%    %           %%%%    %           %%%%    %           %%%%    %           %%
%%    %    %      %%%%    %    %      %%%%    %    %      %%%%    %    %       %%%    %    %      %%
%%         %      %%%%         %      %%%%         %        %%         %      % %%         %      %%
%%         %                   %                   %      %            %      %%           %      %%
%%%  %%%%%%%%%%%%%%%%%%%%%%%%%%%%%%%%%%%%%%%%%%%%%%%%%%%%%%%%%%%%%%%%%%%%%%%%%%%%%%%%%%%%%%%%%% %%%%
%%%  %%%%%%%%%%%%%%%%%%%%%%%%%%%%%%%%%%%%%%%%%%%%%%%%%%%%%%%%%%%%%%%%%%%%%%%%%%%%%%%%%%%%%%%%%% %%%%
%%%  %%%%%%%%%%%%%%%%%%%%%%%%%%%%%%%%%%%%%%%%%%%%%%%%%%%%%%%%%%%%%%%%%%%%%%%%%%%%%%%%%%%%%%%%% %%%%%
%%%  %%%%%%%%%%%%%%%%%%%%%%%%%%%%%%%%%%%%%%%%%%%%%%%%%%%%%%%%%%%%%%%%%%%%%%%%%%%%%%%%%%%%%%%% %%%%%%
%%    %%%%%%      %%%%    %%%%%%              %%%%%%      %%%%    %%%%%%      %%%%    %%%%%%      %%
%%    %%%%%%      %%%%    %%%%%%      %%%%    %%%%%%      %%%%    %%%%%%      %%%%    %%%%%%      %%
%%    %           %%%%    %           %%%%    %           %%%%    %           %%%%    %           %%
%%    %    %      %%%%    %    %      %%%%    %    %      %%%%    %    %       %%%    %    %      %%
%%         %      %%%%         %      %%%%         %        %%         %      % %%         %      %%
%%         %                   %                   %      %            %      %%           %      %%
%%%%  %%%%%%%%%%%%%%%%%%%%%%%%%%%%%%%%%%%%%%%%%%%%%%%%%%%%%%%%%%%%%%%%%%%%%%%%%%%%%%%%%%%%%%%%%%%%%%
%%%%  %%%%%%%%%%%%%%%%%%%%%%%%%%%%%%%%%%%%%%%%%%%%%%%%%%%%%%%%%%%%%%%%%%%%%%%%%%%%%%%%%%%%%%%%%%%%%%
%%%%  %%%%%%%%%%%%%%%%%%%%%%%%%%%%%%%%%%%%%%%%%%%%%%%%%%%%%%%%%%%%%%%%%%%%%%%%%%%%%%%%%%%%%%%%%%%%%%
%%%%  %%%%%%%%%%%%%%%%%%%%%%%%%%%%%%%%%%%%%%%%%%%%%%%%%%%%%%%%%%%%%%%%%%%%%%%%%%%%%%%%%%%%%%%%%%%%%%
%%    %%%%%%      %%%%    %%%%%%              %%%%%%      %%%%    %%%%%%      %%%%    %%%%%%      %%
%%    %%%%%%      %%%%    %%%%%%      %%%%    %%%%%%      %%%%    %%%%%%      %%%%    %%%%%%      %%
%%    %           %%%%    %           %%%%    %           %%%%    %           %%%%    %           %%
%%    %    %      %%%%    %    %      %%%%    %    %      %%%%    %    %       %%%    %    %      %%
%%         %      %%%%         %      %%%%         %        %%         %      % %%         %      %%
%%         %                   %                   %      %            %      %%           %      %%
%%%%%%%%%%%%%%%%%%%%%%%%%%%%%%%%%%%%%%%%%%  %%%%%%%%%%%%%%%%%%%%%%%%%%%%%%%%%%%%%%%%%%%%%%%%%%  %%%%
%%%%%%%%%%%%%%%%%%%%%%%%%%%%%%%%%%%%%%%%%%  %%%%%%%%%%%%%%%%%%%%%%%%%%%%%%%%%%%%%%%%%%%%%%%%%%  %%%%
%%%%%%%%%%%%%%%%%%%%%%%%%%%%%%%%%%%%%%%%%%  %%%%%%%%%%%%%%%%%%%%%%%%%%%%%%%%%%%%%%%%%%%%%%%%%   %%%%
%%%%%%%%%%%%%%%%%%%%%%%%%%%%%%%%%%%%%%%%%%  %%%%%%%%%%%%%%%%%%%%%%%%%%%%%%%%%%%%%%%%%%%%%%%%  %%%%%%
%%    %%%%%%      %%%%    %%%%%%              %%%%%%      %%%%    %%%%%%      %%%%    %%%%%%      %%
%%    %%%%%%      %%%%    %%%%%%      %%%%    %%%%%%      %%%%    %%%%%%      %%%%    %%%%%%      %%
%%    %           %%%%    %           %%%%    %           %%%%    %           %%%%    %           %%
%%    %    %      %%%%    %    %      %%%%    %    %      %%%%    %    %       %%%    %    %      %%
%%         %      %%%%         %      %%%%         %        %%         %      % %%         %      %%
%%         %                   %                   %      %            %      %%           %      %%
%%%%%%%%%%%%%%%%%%%%%%%%%%%%%%%%%%%%%%%%%%%%%%%%%%%%%%%%%%%%%%%%%%%%%%%%%%%%%%%%%%%%%%%%%%%%%%%  %%%
%%%%%%%%%%%%%%%%%%%%%%%%%%%%%%%%%%%%%%%%%%%%%%%%%%%%%%%%%%%%%%%%%%%%%%%%%%%%%%%%%%%%%%%%%%%%%%%  %%%
%%%%%%%%%%%%%%%%%%%%%%%%%%%%%%%%%%%%%%%%%%%%%%%%%%%%%%%%%%%%%%%%%%%%%%%%%%%%%%%%%%%%%%%%%%%%%%%  %%%
%%%%%%%%%%%%%%%%%%%%%%%%%%%%%%%%%%%%%%%%%%%%%%%%%%%%%%%%%%%%%%%%%%%%%%%%%%%%%%%%%%%%%%%%%%%%%%%  %%%
%% @  %%%%%%      %%%%    %%%%%%              %%%%%%      %%%%    %%%%%%      %%%%    %%%%%%      %%
%%    %%%%%%      %%%%    %%%%%%      %%%%    %%%%%%      %%%%    %%%%%%      %%%%    %%%%%%      %%
%%    %           %%%%    %           %%%%    %           %%%%    %           %%%%    %           %%
%%    %    %      %%%%    %    %      %%%%    %    %      %%%%    %    %       %%%    %    %      %%
%%         %      %%%%         %      %%%%         %        %%         %      % %%         %      %%
%%         %                   %                   %      %            %      %%           %      %%
%%%  %%%%%%%%%%%%%%%%%%%%%%%%%%%%%%%%%%%%%%%%%%%%%%%%%%%%%%%%%%%%%%%%%%%%%%%%%%%%%%%%%%%%%%%%%% %%%%
%%%  %%%%%%%%%%%%%%%%%%%%%%%%%%%%%%%%%%%%%%%%%%%%%%%%%%%%%%%%%%%%%%%%%%%%%%%%%%%%%%%%%%%%%%%%%% %%%%
%%%  %%%%%%%%%%%%%%%%%%%%%%%%%%%%%%%%%%%%%%%%%%%%%%%%%%%%%%%%%%%%%%%%%%%%%%%%%%%%%%%%%%%%%%%%% %%%%%
%%%  %%%%%%%%%%%%%%%%%%%%%%%%%%%%%%%%%%%%%%%%%%%%%%%%%%%%%%%%%%%%%%%%%%%%%%%%%%%%%%%%%%%%%%%% %%%%%%
%%    %%%%%%      %%%%    %%%%%%              %%%%%%      %%%%    %%%%%%      %%%%    %%%%%%      %%
%%    %%%%%%      %%%%    %%%%%%      %%%%    %%%%%%      %%%%    %%%%%%      %%%%    %%%%%%      %%
%%    %           %%%%    %           %%%%    %           %%%%    %           %%%%    %           %%
%%    %    %      %%%%    %    %      %%%%    %    %      %%%%    %    %       %%%    %    %      %%
%%         %      %%%%         %      %%%%         %        %%         %      % %%         %      %%
%%         %                   %                   %      %            %      %%           %      %%
%%%%  %%%%%%%%%%%%%%%%%%%%%%%%%%%%%%%%%%%%%%%%%%%%%%%%%%%%%%%%%%%%%%%%%%%%%%%%%%%%%%%%%%%%%%%%%%%%%%
%%%%  %%%%%%%%%%%%%%%%%%%%%%%%%%%%%%%%%%%%%%%%%%%%%%%%%%%%%%%%%%%%%%%%%%%%%%%%%%%%%%%%%%%%%%%%%%%%%%
%%%%  %%%%%%%%%%%%%%%%%%%%%%%%%%%%%%%%%%%%%%%%%%%%%%%%%%%%%%%%%%%%%%%%%%%%%%%%%%%%%%%%%%%%%%%%%%%%%%
%%%%  %%%%%%%%%%%%%%%%%%%%%%%%%%%%%%%%%%%%%%%%%%%%%%%%%%%%%%%%%%%%%%%%%%%%%%%%%%%%%%%%%%%%%%%%%%%%%%
%%    %%%%%%      %%%%    %%%%%%              %%%%%%      %%%%    %%%%%%      %%%%    %%%%%%      %%
%%    %%%%%%      %%%%    %%%%%%      %%%%    %%%%%%      %%%%    %%%%%%      %%%%    %%%%%%      %%
%%    %           %%%%    %           %%%%    %           %%%%    %           %%%%    %           %%
%%    %    %      %%%%    %    %      %%%%    %    %      %%%%    %    %       %%%    %    %      %%
%%         %      %%%%         %      %%%%         %        %%         %      % %%         %      %%
%%         %                   %                   %      %            %      %%           %      %%
%%%%%%%%%%%%%%%%%%%%%%%%%%%%%%%%%%%%%%%%%%  %%%%%%%%%%%%%%%%%%%%%%%%%%%%%%%%%%%%%%%%%%%%%%%%%%  %%%%
%%%%%%%%%%%%%%%%%%%%%%%%%%%%%%%%%%%%%%%%%%  %%%%%%%%%%%%%%%%%%%%%%%%%%%%%%%%%%%%%%%%%%%%%%%%%%  %%%%
%%%%%%%%%%%%%%%%%%%%%%%%%%%%%%%%%%%%%%%%%%  %%%%%%%%%%%%%%%%%%%%%%%%%%%%%%%%%%%%%%%%%%%%%%%%%   %%%%
%%%%%%%%%%%%%%%%%%%%%%%%%%%%%%%%%%%%%%%%%%  %%%%%%%%%%%%%%%%%%%%%%%%%%%%%%%%%%%%%%%%%%%%%%%%  %%%%%%
%%    %%%%%%      %%%%    %%%%%%              %%%%%%      %%%%    %%%%%%      %%%%    %%%%%%      %%
%%    %%%%%%      %%%%    %%%%%%      %%%%    %%%%%%      %%%%    %%%%%%      %%%%    %%%%%%      %%
%%    %           %%%%    %           %%%%    %           %%%%    %           %%%%    %           %%
%%    %    %      %%%%    %    %      %%%%    %    %      %%%%    %    %       %%%    %    %      %%
%%         %      %%%%         %      %%%%         %        %%         %      % %%         %      %%
%%         %                   %                   %      %            %      %%           %      %%
%%%%% %%%%%%%%%%%%%%%%%%%%%%%%%%%%%%%%%%%%%%%%%%%%%%%%%%%%%%%%%%%%%%%%%%%%%%%%%%%%%%%%%%%%%%%%%%%%%%
%%%%% %%%%%%%%%%%%%%%%%%%%%%%%%%%%%%%%%%%%%%%%%%%%%%%%%%%%%%%%%%%%%%%%%%%%%%%%%%%%%%%%%%%%%%%%%%%%%%
%%%%  %%%%%%%%%%%%%%%%%%%%%%%%%%%%%%%%%%%%%%%%%%%%%%%%%%%%%%%%%%%%%%%%%%%%%%%%%%%%%%%%%%%%%%%%%%%%%%
%%%%  %%%%%%%%%%%%%%%%%%%%%%%%%%%%%%%%%%%%%%%%%%%%%%%%%%%%%%%%%%%%%%%%%%%%%%%%%%%%%%%%%%%%%%%%%%%%%%
%%    %%%%%%      %%%%    %%%%%%              %%%%%%      %%%%    %%%%%%      %%%%    %%%%%%      %%
%%    %%%%%%      %%%%    %%%%%%      %%%%    %%%%%%      %%%%    %%%%%%      %%%%    %%%%%%      %%
%%    %           %%%%    %           %%%%    %           %%%%    %           %%%%    %           %%
%%    %    %      %%%%    %    %      %%%%    %    %      %%%%    %    %       %%%    %    %      %%
%%         %      %%%%         %      %%%%         %        %%         %      % %%         %      %%
%%         %                   %                   %      %            %      %%           %      %%
%%%%%%%%%%%%%%%%%%%%%%%%%%%%%%%%%%%%%%%%%%  %%%%%%%%%%%%%%%%%%%%%%%%%%%%%%%%%%%%%%%%%%%%%%%%%%  %%%%
%%%%%%%%%%%%%%%%%%%%%%%%%%%%%%%%%%%%%%%%%%  %%%%%%%%%%%%%%%%%%%%%%%%%%%%%%%%%%%%%%%%%%%%%%%%%%  %%%%
%%%%%%%%%%%%%%%%%%%%%%%%%%%%%%%%%%%%%%%%%%  %%%%%%%%%%%%%%%%%%%%%%%%%%%%%%%%%%%%%%%%%%%%%%%%%   %%%%
%%%%%%%%%%%%%%%%%%%%%%%%%%%%%%%%%%%%%%%%%%  %%%%%%%%%%%%%%%%%%%%%%%%%%%%%%%%%%%%%%%%%%%%%%%%  %%%%%%
%%    %%%%%%      %%%%    %%%%%%              %%%%%%      %%%%    %%%%%%      %%%%    %%%%%%      %%
%%    %%%%%%      %%%%    %%%%%%      %%%%    %%%%%%      %%%%    %%%%%%      %%%%    %%%%%%      %%
%%    %           %%%%    %           %%%%    %           %%%%    %           %%%%    %           %%
%%    %    %      %%%%    %    %      %%%%    %    %      %%%%    %    %       %%%    %    %      %%
%%         %      %%%%         %      %%%%         %        %%         %      % %%         %    * %%
%%         %                   %                   %      %            %      %%           %      %%
%%%%%%%%%%%%%%%%%%%%%%%%%%%%%%%%%%%%%%%%%%%%%%%%%%%%%%%%%%%%%%%%%%%%%%%%%%%%%%%%%%%%%%%%%%%%%%%%%%%%
%%%%%%%%%%%%%%%%%%%%%%%%%%%%%%%%%%%%%%%%%%%%%%%%%%%%%%%%%%%%%%%%%%%%%%%%%%%%%%%%%%%%%%%%%%%%%%%%%%%%